################################
#        #              #      #
#  ####  ####  #  ####  #   ####
#     #        #  #  #         #
####  ####  #######  #  ####   #
#        #     #           #   #
#######  #######################
#        #     #     #         #
####  #  #  #######  #######   #
#     #     #  #        #      #
#  ##########  #  #  #  #   ####
#     #  #        #  #         #
####  #  #  #  #######  ########
#        #  #  #  #     #      #
####  #######  #  #  #######   #
#  #        #     #  #         #
#  #  #############  #######   #
#           #        #         #
#  ####  ####  ####  #######   #
#  #     #        #  #         #
####  #######  #  #  ####   #  #
#  #  #  #     #  #     #   #  #
#  #  #  #  #  #  ####  #   #  #
#           #  #  #         #  #
#############  #  #  #   #######
#              #  #  #      #  #
#  #  #  #  #  #  ####  #   #  #
#  #  #  #  #  #  #  #  #      #
#  ####  ####  ####  #  #   ####
#     #  #  #     #     #      #
#           #  #        #     !#
################################
